1111111111111111111111111
1P00001v000<1000000000v01
10011110010010v1111111001
1000001001>0000100C000001
1001001001001111111111001
1001^000C10000C1001v01001
11110011111111110v1001001
1CC10000C1000C00000000001
1CC11111110011111111110^1
1001001C00000000000000<01
1001001111111111001111111
1>00001001000001C000v1001
1111001001001001111001111
1>00000001001000000001001
1111001111111111001001111
1C010000000010C1001001vC1
10011110011110v1001111001
1000000001000000C010C1001
1001111001011111001001001
1E^1>00000000000000000001
1111111111111111111111111
