1111111111111111111111111111111111111
1PC00000v1000000000000000000000000001
11110010011111110^1111^01111>01111001
100000100100>001C01C00001000000001C01
1001111001001001111111111001111111111
1C^1001^00001000000v000000000000010C1
1111001111111111111001111111111001v01
1001v01001C000000000000000000C1001001
1111001001111111111001111111111111011
1C000000000C10010010^0000000000000001
1111001111111001001111111111111111001
10000000C10^0001000000001000000001001
1001001111^01111001111001vC1111Cv1101
10010^0000000000001000000001000000001
1001111111111v01^v1111001111111111001
1^01>000000010v1001C000>0000001C00001
1001001001001111001001111001001111001
1C000010C1C000E1001001C00001001C00^C1
1111111111111111111111111111111111111
