11111111111111
1v000v>v0<0001
100>000^<v0001
1>0v0v0>000001
1000011100vv01
1>001PCE10v0^1
1v000111>000^1
1>000^v0v^0001
1<v0^00>v00^01
10<0v00>>00v01
100^00>000^0^1
11111111111111
