11111
10E01
11C11
1>001
11C11
100<1
11C11
1>001
11P11
11111
