1111111111111
1C00000000001
1111001^1>001
100000101>001
10C1v^P1110C1
10C10010C1C01
10C1001^010C1
10000000010E1
1111111111111
