111111111111111111111
1EC010100000100>00001
111010101110101011111
10>010001>00001000001
111010101111101111101
100<10101000100C1C101
101010101010111110101
1010001000101000001C1
101110111110111011111
10001C1>0000000010101
111111111010111010101
10001C1000101>000^101
111010101110111010101
1>00001C00100010100v1
1011111110111C1111101
100C101C1010101010101
101110101010111010101
10000000100000000<1C1
111^11101110101011111
1000001000001C10000P1
111111111111111111111
