1111111111111111111
10P0001>000CC0000v1
1^01111001111111001
10000<1C01000<00>01
10C1111001111111001
10000C1000000000001
10C11110C1111001111
100000100>0010000C1
1111001001001001111
10>00010010C10000C1
1001001C01111v^1111
1C01000001C000000C1
1111001001111001111
1C000^10C1C000000E1
1111111111111111111
