11111111
111CC111
111>0111
1C0P0vC1
1C^000C1
1110<111
111CE111
11111111
