1111111111
1000<C0001
10000C>v01
1000100001
1C0>000001
1001EP0001
1^01C000v1
1000000001
100<C00001
10000>00C1
1111111111
