11111111111
1><0vv0><11
1><0^^0><11
11111111111
1PCCCCCCE11
11111111111
1>00>00>001
1<00<00<001
11111111111
