11111
10C01
1^1P1
10E01
11111
