1111111111111111111
1000000000000000001
1011110000100000001
1001C10001010000001
1111111111001100111
1000000C00000010001
10000C00000001P1001
1000C000000E00C0001
1111111111111111111