11111111111
1EC00010001
11111011101
10001000001
10101111101
10100000001
11101110101
10001000101
10111111101
10000P10001
11111111111
