11111
10C01
1P1C1
10E01
11111
