111111111111111111111111111
1P000000000000000C1C0000001
111111111111111110101111101
100010001000000C001010C0101
10101C101011111111101010101
10101010101E000000001010101
101010101011111111111010101
101010101010000C00000010101
101C10101010111111111110101
101000100010100C00000000101
101111111110101111111111101
100000000000100000000000001
111111111111111111111111111