11111111111
1CCCCCCCCC1
1C1111111C1
1C1CCCCC1C1
1C1C111C1C1
1C1C1ECC1C1
1C1C11111C1
1P1CCCCCCC1
11111111111
